100110100101010101101
111111011111101111110
110101001001011001011
110111111111011110010
110100111101110010111
000111111001011110110
011100001001111010111
011001101111101000011
011111111101111011011
011010101010101001111
100110100101011101101
111111010111101111110
110101001001011001011
110111111011011110010
110100111100110010111
000111111001011110110
011100001001111010111
011001101111101000011
011111111101111111000
011010101010101001111